147
Aaron	Masculin
Achille	Masculin
Adonis	Masculin
Ajax	Masculin
Albert	Masculin
Alceste	Masculin
Alcibiade	Masculin
Alexandre	Masculin
Amphitryon	Masculin
Antigone	Masculin
Antoine	Masculin
Apollon	Masculin
Archimede	Masculin
Ares	Masculin
Ariarathe	Masculin
Aristide	Masculin
Aristophane	Masculin
Aristote	Masculin
Athos	Masculin
Azel	Masculin
Benjamin	Masculin
Barnabe	Masculin
Cleon	Masculin
Cyriacus	Masculin
Cyrille	Masculin
David	Masculin
Eleazar	Masculin
Emile	Masculin
Enee	Masculin
Ephise	Masculin
Eros	Masculin
Eschyle	Masculin
Eusebe	Masculin
Exupere	Masculin
Gordius	Masculin
Hades	Masculin
Hector	Masculin
Hermes	Masculin
Hercule	Masculin
Heracles	Masculin
Hera	Masculin
Helenos	Masculin
Homere	Masculin
Horace	Masculin
Hyacinthe	Masculin
Isaac	Masculin
Icare	Masculin
Jason	Masculin
Josue	Masculin
Joachim	Masculin
Jerome	Masculin
Jules	Masculin
Leonidas	Masculin
Lazare	Masculin
Matthias	Masculin
Moise	Masculin
Moshe	Masculin
Moses	Masculin
Marcus	Masculin
Nicolas	Masculin
Narcisse	Masculin
Neree	Masculin
Nearque	Masculin
Nicodeme	Masculin
Nicomede	Masculin
Orphee	Masculin
Octave	Masculin
Ourea	Masculin
Ovide	Masculin
Pamphile	Masculin
Paris	Masculin
Philippe	Masculin
Patrocle	Masculin
Pausianas	Masculin
Phinee	Masculin
Priam	Masculin
Polites	Masculin
Polyeucte	Masculin
Remus	Masculin
Romulus	Masculin
Rufus	Masculin
Sabin	Masculin
Sebastien	Masculin
Simon	Masculin
Sophocle	Masculin
Stephane	Masculin
Thales	Masculin
Theophraste	Masculin
Tibulle	Masculin
Timon	Masculin
Tybalt	Masculin
Ulysse	Masculin
Virgile	Masculin
Virgile	Masculin
Zenon	Masculin
Zeus	Masculin
Aphrodite	Feminin
Artemis	Feminin
Aspasie	Feminin
Athena	Feminin
Agathe	Feminin
Andromaque	Feminin
Andromede	Feminin
Ariane	Feminin
Antigone	Feminin
Berenice	Feminin
Calliope	Feminin
Cassandre	Feminin
Cassiopee	Feminin
Catherine	Feminin
Circe	Feminin
Clio	Feminin
Clytia	Feminin
Clytie	Feminin
Chloe	Feminin
Cybele	Feminin
Danae	Feminin
Daphne	Feminin
Daphnis	Feminin
Demi	Feminin
Diane	Feminin
Dione	Feminin
Eulalie	Feminin
Eurydice	Feminin
Euterpe	Feminin
Fama	Feminin
Firmine	Feminin
Gaia	Feminin
Hecube	Feminin
Helene	Feminin
Hera	Feminin
Junon	Feminin
Leto	Feminin
Latone	Feminin
Marguerite	Feminin
Marie	Feminin
Myriam	Feminin
Maia	Feminin
Medee	Feminin
nirosia	Feminin
Penelope	Feminin
Persephone	Feminin
Proserpine	Feminin
Stratonice	Feminin
Silene	Feminin
Xena	Feminin
Xenia	Feminin

